20 7
0 18
6 12
XXXXXXXXXXXXXXXXXX X
X     X      XXXXX X
X XXXXX XXXX X  XX X
X XXXXX XXXX XX XX X
X X        X XX XX X
X XXXXXXXXXX       X
XXXXXXXXXXXX XXXXXXX


# Might backtrack or not
# depending on order of directions being tried
*** Solving maze2.txt
Path: NEEEEEENNNNN
XXXXXXXXXXXXXXXXXX*X
X     X++++++XXXXX*X
X XXXXX+XXXX+X++XX*X
X XXXXX+XXXX+XX+XX*X
X X++++++++X+XX+XX*X
X XXXXXXXXXX*******X
XXXXXXXXXXXX*XXXXXXX

